#######
#S     
# ### #
#   #  
### # #
#     ?
# #####
#######