BBBBBBBBBBBBBBBBBBB
*.................B
BCBBBBBBBBBBBBBBC.B
B......BBBBBBBBBC.B
B..BBBCBBBBBBBBBC.B
B.................B
B.CBBBBBBBBBBBBBBCB
B..............C..B
B.BBBBBBBBBBBBBB..B
B.CCCC............B
B.BBBBBBBBBBBBBB..B
B.................B
B.CBBBBBBBBBBBBBBBB
B.................B
BCCBBBBBBBBBBBBBC.B
B.................B
B....C.CCCCCBBBBBBB
B...CC.BBBBBCBB...+
B...BC..........CCB
BBBBBBBBBBBBBBBBBBB
